region1 = {
	provinces = {
		79 80 81 82 83 84 85 86 87 88 89 90 91 92 93 94 95 96 97 98 99 100 101 102 103 104 105 106 107 108 109 110 111 112 113 114 115 116 117 118 119 120 121 122 123 124 125 126 127 128 129 130 131 132 133 134 135 136 137 138 139 140 141 142 143 144 145 146 147 148 149 150 151 152 153 154 155 156 157 158 159 160 161 162 163 164 165 166 167 168 169 170 171 172 173 174 175 176 177 178 179 180 181 182 183 184 185 186 187 188 189 190 191 192 193 194 195 196 197 198 199 200 201 202 203 204 205 206 207 208 209 210 211 212 213 214 215 216 217 218 219 220 221 222 223 224 225 226 227 228 229 230 231 232 233 234 235 236 237 238 239 240 241 242 243 244 245 246 247 248 249 250 251 252 253 255 256 257 258 259 260 261 262 263 264 265 266 268 269 271 272 273 274 275 276 277 278 279 280 281 282 283 284 285 286 287 289 290 291 293 296 297 298 299 302 307 312 303 317 313 305 323 

	}

	farm_rgo_size = 2
	mine_rgo_size = 2
}

region2 = {
	provinces = {
		292 294 295 306 310 300 304 308 309 311 314 315 316 318 319 320 321 322 324 325 326 327 328 329 331 332 333 334 335 336 337 339 340 341 342 343 345 346 347 348 349 350 351 352 353 354 355 357 359 360 361 362 363 365 366 367 368 369 371 372 373 374 375 376 378 379 382 385 386 

	}

}

region3 = {
	provinces = {
		377 380 383 384 387 388 389 390 391 392 393 394 395 396 397 398 399 400 401 403 404 405 406 407 408 409 410 411 412 413 414 417 418 419 420 421 422 423 424 425 427 428 432 433 

	}
}

region4 = {
	provinces = {
		431 434 436 437 438 440 441 442 443 444 445 446 447 448 449 450 451 452 453 454 455 456 457 458 459 460 461 462 463 464 465 466 467 468 469 470 471 472 473 474 475 476 477 478 479 480 481 482 483 484 
	}
	
	farm_rgo_size = 2.5
	mine_rgo_size = 2.5
}

region5 = {
	provinces = {
		485 486 487 488 489 490 491 492 493 494 495 496 497 498 499 500 501 502 503 504 505 506 507 508 509 510 511 512 513 514 515 516 517 518 519 520 521 522 523 524 525 526 527 528 529 530 531 532 533 534 535 536 537 538 539 540 541 542 543 544 545 546 547 548 549 550 551 552 553 554 555 556 557 558 559 560 561 562 563 564 565 566 567 568 569 570 571 572 573 574 575 576 577 578 579 580 581 582 583 584 585 586 587 588 589 590 591 592 

	}

}

region6 = {
	provinces = {
		267 270 254 288 301 330 344 364 356 338 358 370 381 402 429 435 415 439 416 426 430
	}

}
